NO tx/dungeon/ND.xpm
SO tx/dungeon/SD.xpm
WE tx/dungeon/WED.xpm
EA tx/dungeon/ED.xpm

F 0, 0, 0
C 71, 71, 71

1111111    111111
100S001    100001
1000001    100001
1000001111110000111111
1000000000000000000001
1111000000111110001111
1111000000111110001111
1111000000000000001111
1111000011111111101111
1111000011111111101111
1111111111111111101111
                101111
                101111
            1111100011
            1000000001
            1000000001
            1111111111