NO tx/N.xpm
SO tx/N.xpm
WE tx/N.xpm
EA tx/N.xpm

F 0,0,200
C 0,0,200

1111111
1S00001
1011101
101 101
1011101
1000001 
1111111