NO tx/ice/2.xpm
SO tx/ice/3.xpm
EA tx/ice/1.xpm
WE tx/ice/4.xpm

F 0,97,167
C 204,233,251

11111     11111
100011111110001
100000000000001
100011101110001
110111000111011
 1000000000001
110111000111011
100011101110001
100000000000N01
100011111110001
11111     11111