NO tx/tile/t1.xpm
SO tx/tile/t2.xpm
WE tx/tile/t3.xpm
EA tx/tile/t4.xpm

C 180, 210, 220
F 70, 40, 37

1111111111111111111111111111111111111111111111111111111111111
1000000000000000011011000000011100000000000000000000001111111
1000100000000000011011000000011100000000000000000000001111111
1001S10001111100011011001110011100111111111111111111001111111
1000000001100000011011001110011100111111111111111111001111111
1000000001100000011011001111111100111111111111111111001111111
1111111111100111111011000000000000111111111111111111001111111
1000000001100111111000000000000000111111111111000000000000001
1000000000000111111111001111111111111111111111000000000000001
1001111000000111111111001111111111111111111111100000000000011
1001111111111111110000000000111111000000111111100000110000011
1001101101101101110000000000111111000000111111000000110000001
1000000000000000000000000000111111111100111111000000000000001
1000000000000000000000000000111111111100111111000000000000001
1111101101101101110000000000111110000000111111000000000000001
1111111111111111110000000000111110000000111111111111001111111
1111100001111111111111001111111110011111111111111111001111111
1111100001111111111111001111111110011111111111111111001111111
1111110011111111111111001111111110011111111111111111001111111
1111110000000000000000001111111110011111111111111100000011111
1111110000000000000000001111111110000000000000000000000011111
1111111111111111111111111111111110000000000000000000000011111
1111111111111111111111111111111111111111111111111100000011111
1111111111111111111111111111111111111111111111111111111111111