NO tx/N.xpm
SO tx/S.xpm
WE tx/WE.xpm
EA tx/E.xpm

F 20,20,20
C 200,200,200

111111111111111111111
1W0000000000000000001
111111111111111111111
