NO tx/NORTH.xpm
SO tx/NORTH.xpm
WE tx/NORTH.xpm
EA tx/NORTH.xpm

F 0,0,200
C 0,0,200

1111111
10000W1
1000101
1000001
1111111