NO tx/N.xpm
SO tx/E.xpm
WE tx/S.xpm
EA tx/WE.xpm

F 0,255,255
C 255, 0, 0

11111
10001
10E01
11111