NO tx/N.xpm
SO tx/PS.xpm
WE tx/GW.xpm
EA tx/GE.xpm

F 0,128,128
C 0, 51, 102

11111
10001
10E01
11111