NO tx/N.xpm
SO tx/N.xpm
WE tx/N.xpm
EA tx/N.xpm

F 0,255,255
C 255, 0, 0

1111111
10000S1
1000101
1000001
1111111