NO tx/N.xpm
SO tx/PS.xpm
WE tx/GW.xpm
EA tx/GE.xpm

F 0,255,255
C 255, 0, 0

111111111
110000011
110000011
1000N0001
100000001
100000001
100000001
100000001
100000001
100000001
100000001
111111111