NO tx/NORTH.xpm
SO tx/NORTH.xpm
WE tx/NORTH.xpm
EA tx/NORTH.xpm

F 0,0,200
C 0,0,200

1111111
1S00001
1011101
101 101
1011101
1000001 
1111111