NO tx/NORTH.xpm
SO tx/NORTH.xpm
WE tx/NORTH.xpm
EA tx/NORTH.xpm

F 0,0,200
C 0,0,200

1111111
1S00001111
1011100001
101 111101
1011   101     1111
1001   1011111110011
1001   10000110000011
1011   11000110010001
1011    1000000111001
10011   11100111 10011
100011    1111   100011
1100011          110001 
11100011          11001 
  110001111111111110011
   11000000000000000011
    110000000000000111
     111111001111111
          1111