NO tx/ice/NI.xpm
SO tx/ice/SI.xpm
EA tx/ice/EI.xpm
WE tx/ice/WI.xpm

F 0,97,167
C 204,233,251

11111     11111
100011111110001
100000000000001
100011101110001
110111000111011
 1000000000001
110111000111011
100011101110001
100000000000N01
100011111110001
11111     11111