NO tx/N.xpm
SO tx/N.xpm
WE tx/N.xpm
EA tx/N.xpm

F 0,0,200
C 0,0,200

11111     11111
100011111110001
100000000000001
100011101110001
110111000111011
 1000000000001
110111000111011
100011101110001
100000000000N01
100011111110001
11111     11111