NO tx/N.xpm          
SO tx/N.xpm
WE tx/N.xpm
EA tx/N.xpm

F 0,0,200
C 0,0,200

11111
10001
10E01
10001
11111   111111
        100001
        100001
        100001
        111111