NO tx/N.xpm          
SO tx/N.xpm
WE tx/N.xpm
EA tx/N.xpm

F 0,0,200
C 0,0,200
 
          11111
111       10001     111
          10E01     101
          10001     111
          11111          1       
   1              111111
                  100001     1
                  100001
    111           100001    
                  111111
                1


          
             


               