NOtx/NORTH.xpm
SO tx/NORTH.xpm
WE tx/NORTH.xpm
EA tx/NORTH.xpm

F 000000001          ,       000000000000000000019,         255          
C 0, 231 , 200 

11111111111111111111111
10000000000100000000001
10000000001000000000001
10000000010100000N00001
10000000001000000000001
10000000000000000000001
10000000000100000000001
11111111111111111111111