NO textura norte
SO textura sul
WE textura Oeste
EA textura este

F 0,0,200
C 0,0,200

11111111111111111111111
10000000000100000000001
10000000001000000000001
10000000010100000000001
100000000010N0000000001
10000000000000000000001
10000000000100000000001
11111111111111111111111
