NO textura norte
SO textura sul
WE textura Oeste
EA textura este

F 0,0,200
C 0,0,200

111111
100011
1N0111
100001
100101
111001
110001
111111
