NO textura norte
SO textura sul
WE textura Oeste
EA textura este

F 0,0,200
C 0,0,200

11111111111111111111111
10001100000000001111111
10011100000111111110001
10000111000001100000111
10010000000N00001000001
11100011100001111001111
11000110001111100001011
11111111111111111111111
