               NO             tx/spaces   in    filename     .xpm      



SO tx/N.xpm    





WE              tx/N.xpm    
                                     EA tx/N.xpm   





F 0,0,200




C 0  ,    0,                   200

11111111111
10000100001
10001000001
10E00000001
10001000001
10000100001
11111111111