NO tx/NORTH.xpm



SO tx/NORTH.xpm


EA tx/NORTH.xpm



WE tx/NORTH.xpm



F 0,0,200
C 0,0,200


1



                                                              111
                                                              101
                                                              111




                          11111111
                          100N11
                          11111111




                                                                                                                                111
101
111

                                                        111
                                                        101
                                                        111


           111
           101
           111
                                                                         111
                                                                         101
                                                                         111


1                                                                                                                     1