1111
1N01
1111

NO tx/N.xpm
SO tx/N.xpm
WE tx/N.xpm
EA tx/N.xpm

F 0,0,200
C 0,0,200