1111
1N01
1111

NO tx/NORTH.xpm
SO tx/NORTH.xpm
WE tx/NORTH.xpm
EA tx/NORTH.xpm

F 0,0,200
C 0,0,200