NO tx/NORTH.xpm



SO tx/NORTH.xpm


EA tx/NORTH.xpm



WE tx/NORTH.xpm



F 0,0,200
C 0,0,200

1111111
1000001
1000001
1000001
1000001
1000001
1000001
1111111
