NO tx/N.xpm
SO tx/N.xpm     
WE tx/N.xpm



EA tx/N.xpm






F 000250   ,         2      555555545     , 255  
C 0, 23 , 200 

1111111111
101N0011          1
10000001
10000001
10000001
10000001
10000001
1111111111