    NO tx/N.xpm
SO tx/N.xpm
WE tx/N.xpm
EA tx/N.xpm

            NO tx/N.xpm

WE tx/N.xpm


F 0,0,200
C 0,0,200

11111111111111111111111
10000000000100000000001
10000000001000000000001
10000000010100000N00001
10000000001000000000001
10000000000000000000001
10000000000100000000001
11111111111111111111111